1111111111111111111111111
1000000000110000000000001
1011000001110000200000001
1001002000000000000020001
1011000001110000002000001
1000000000110000011101111
1111011111111111110000001
1111011111111111110121001
1100000011010101110000001
1020000000000000110000001
1000020000000000110101001
1100000011010101111101111
1111011111110111111121111
1111011111110010110000001
1100000111002000110000001
1000000011020200110000001
1000000011111110111000101
1000200011111111111101001
1100000111000111111000111
1000000010000011012101001
1000000000000000000000001
1000000010200011010101001
1100000111000111111000111
1100000111000111111020111
1111111111111111111111111